[[.,.,.,.,.,.,.,,.,.,.,.,.,.,.,.,.,.,.,.,.,.,.,.,.,.,.,.,.,.,.,.,.,.,.,.,.,.,.,.,.],
[.#########☼☼☼☼######...######.....#####.],
[.#.......#☼☼☼ ■....#...#....#..▲..#...#.],
[.#.......#☼☼☼☼#....#...#....#.....#...#.],
[.#.......#☼☼☼☼#....#...#....#.....#...#.],
[.#.##....#..###....#...■....#.....#...#.],
[.#..#....#..#......#...######.....■...#.],
[.#..#....#..#......#..............#...#.],
[.#..#....#..#......#.....#######..#...#.],
[.####■####..####■###.....#.....#..#####.],
[...............#.#.......#.....#........],
[.........................#.....#........],
[.........................■.....#......▲.],
[..▲......................#.....#........],
[.▲.▲.####■■####....#######.....#..#■###.],
[.....#........#....#...........#..#...#.],
[.....#........#....#...........#..#...#.],
[.....#........#..▲.#...........#..#...#.],
[.....#........#....#############..#####.],
[.....#........#.........................]]